...f....
.##.###.
.#....#.
.#..p.#.
.#....#.
.######.
........